#############
#############
####     ####
###       ###
##    D  C ##
##         ##
##         ##
###       ###
####o   s####
#############
#############