##########
#D       #
#        #
#  S     #
#   #### #
#   #s   #
#   #    #
#   #    #
#   #   C#
##########
