#############
#############
####     ####
###       ###
##    D    ##
##         ##
##         ##
###       ###
####o   s####
#############
#############