###############
#   #         #
#   #         #
#  S#    #S   #
#   # DC #    #
#   #    #    #
#   #    #    #
#        #    #
#        #    #
###############
