##########
#        #
#        #
#  #######
#  #s    #
#  #     #
#  #  #  #
#    D#  #
#     #  #
#     #  #
#######  #
#        #
#   S    #
#        #
##########
