###############
#             #
#  s       s  #
#             #
###############
