###############
#    #        #
# s  #   s    #
#    #        #
#    #  ##### #
#    #   C#   #
#    # s  # s #
#    #D   #   #
# ####### #   #
#         #   #
#         #   #
#         #   #
# s   s   # s #
#         #   #
###############
