#############
####     ####
####     ####
#   s       #
#           #
#           #
#     D     #
#           #
#           #
#       S   #
####     ####
####     ####
#############
