##########
#        #
#        #
# C  o   #
# ###### #
#  o D   #
#        #
#        #
#        #
##########
