#######
# s   #
#     #
#    s#
#######
