###########
#         #
#    D    #
#    o    #
##### #####
#         #
# s     s #
#         #
#         #
###########
