#############
#############
####     ####
###   C   ###
##         ##
##         ##
##         ##
###   D   ###
####     ####
#############
#############
