##########
#        #
# #####  #
#        #
#   s    #
#        #
# #####  #
#        #
#        #
##########
