#############
#           #
#           #
#     #     #
#   s # o   #
#     #     #
#  ###D###  #
#     #     #
#   o # s   #
#     #     #
#           #
#           #
#############
