#####
#s  #
#   #
#  s#
#####
