##########
#        #
#    D   #
#        #
#   ######
#        #
# o    o #
#        #
#        #
##########
